time,floors,total
00:00:00,0,0
00:10:00,0,0
00:20:00,0,0
00:30:00,0,0
00:40:00,0,0
00:50:00,0,0
01:00:00,0,0
01:10:00,0,0
01:20:00,0,0
01:30:00,0,0
01:40:00,0,0
01:50:00,0,0
02:00:00,0,0
02:10:00,0,0
02:20:00,0,0
02:30:00,0,0
02:40:00,0,0
02:50:00,0,0
03:00:00,0,0
03:10:00,0,0
03:20:00,0,0
03:30:00,0,0
03:40:00,0,0
03:50:00,0,0
04:00:00,0,0
04:10:00,0,0
04:20:00,0,0
04:30:00,0,0
04:40:00,0,0
04:50:00,0,0
05:00:00,0,0
05:10:00,0,0
05:20:00,0,0
05:30:00,0,0
05:40:00,0,0
05:50:00,0,0
06:00:00,0,0
06:10:00,0,0
06:20:00,0,0
06:30:00,0,0
06:40:00,0,0
06:50:00,0,0
07:00:00,0,0
07:10:00,0,0
07:20:00,0,0
07:30:00,0,0
07:40:00,0,0
07:50:00,0,0
08:00:00,0,0
08:10:00,0,0
08:20:00,0,0
08:30:00,0,1
08:40:00,0,1
08:50:00,0,3
09:00:00,0,3
09:10:00,0,3
09:20:00,0,3
09:30:00,0,3
09:40:00,0,3
09:50:00,0,3
10:00:00,0,3
10:10:00,0,3
10:20:00,0,3
10:30:00,0,3
10:40:00,0,3
10:50:00,0,3
11:00:00,0,3
11:10:00,0,3
11:20:00,0,3
11:30:00,0,3
11:40:00,0,3
11:50:00,0,3
12:00:00,0,3
12:10:00,0,3
12:20:00,0,3
12:30:00,0,3
12:40:00,0,3
12:50:00,0,3
13:00:00,0,3
13:10:00,0,3
13:20:00,0,3
13:30:00,0,3
13:40:00,0,3
13:50:00,0,3
14:00:00,0,3
14:10:00,0,3
14:20:00,0,3
14:30:00,0,3
14:40:00,0,3
14:50:00,0,3
15:00:00,0,3
15:10:00,0,3
15:20:00,0,3
15:30:00,0,3
15:40:00,0,3
15:50:00,0,3
16:00:00,0,3
16:10:00,0,3
16:20:00,1,7
16:30:00,0,8
16:40:00,0,8
16:50:00,0,8
17:00:00,0,8
17:10:00,0,8
17:20:00,0,8
17:30:00,0,8
17:40:00,0,8
17:50:00,0,8
18:00:00,0,8
18:10:00,0,8
18:20:00,0,8
18:30:00,0,8
18:40:00,0,8
18:50:00,0,8
19:00:00,0,8
19:10:00,0,8
19:20:00,0,8
19:30:00,0,8
19:40:00,0,8
19:50:00,0,8
20:00:00,0,8
20:10:00,0,8
20:20:00,0,8
20:30:00,0,8
20:40:00,0,8
20:50:00,0,8
21:00:00,0,8
21:10:00,0,8
21:20:00,0,8
21:30:00,0,8
21:40:00,0,8
21:50:00,0,8
22:00:00,0,8
22:10:00,0,8
22:20:00,0,8
22:30:00,0,8
22:40:00,0,8
22:50:00,0,8
23:00:00,0,8
23:10:00,0,8
23:20:00,0,8
23:30:00,0,8
23:40:00,0,8
23:50:00,0,8
