time,floors,total
00:00:00,0,0
00:10:00,0,0
00:20:00,0,0
00:30:00,0,0
00:40:00,0,3
00:50:00,0,3
01:00:00,0,3
01:10:00,0,3
01:20:00,0,3
01:30:00,0,3
01:40:00,0,3
01:50:00,0,3
02:00:00,0,3
02:10:00,0,3
02:20:00,0,3
02:30:00,0,3
02:40:00,0,3
02:50:00,0,3
03:00:00,0,3
03:10:00,0,3
03:20:00,0,3
03:30:00,0,3
03:40:00,0,3
03:50:00,0,3
04:00:00,0,3
04:10:00,0,3
04:20:00,0,3
04:30:00,0,3
04:40:00,0,3
04:50:00,0,3
05:00:00,0,3
05:10:00,0,3
05:20:00,0,3
05:30:00,0,3
05:40:00,0,3
05:50:00,0,3
06:00:00,0,3
06:10:00,0,3
06:20:00,0,3
06:30:00,0,3
06:40:00,0,3
06:50:00,0,3
07:00:00,0,3
07:10:00,0,3
07:20:00,0,3
07:30:00,0,3
07:40:00,0,3
07:50:00,0,3
08:00:00,0,3
08:10:00,0,3
08:20:00,0,3
08:30:00,0,3
08:40:00,0,3
08:50:00,0,3
09:00:00,0,3
09:10:00,0,3
09:20:00,0,3
09:30:00,0,3
09:40:00,0,3
09:50:00,0,3
10:00:00,0,3
10:10:00,0,3
10:20:00,0,3
10:30:00,0,3
10:40:00,0,3
10:50:00,0,3
11:00:00,0,3
11:10:00,0,3
11:20:00,0,3
11:30:00,0,3
11:40:00,0,6
11:50:00,0,6
12:00:00,0,6
12:10:00,0,6
12:20:00,0,6
12:30:00,0,6
12:40:00,0,6
12:50:00,3,9
13:00:00,0,9
13:10:00,0,9
13:20:00,0,9
13:30:00,0,9
13:40:00,0,9
13:50:00,0,9
14:00:00,0,9
14:10:00,0,9
14:20:00,0,9
14:30:00,0,9
14:40:00,0,9
14:50:00,0,9
15:00:00,0,9
15:10:00,0,9
15:20:00,0,9
15:30:00,0,9
15:40:00,0,9
15:50:00,0,9
16:00:00,0,9
16:10:00,0,9
16:20:00,0,9
16:30:00,0,9
16:40:00,0,9
16:50:00,0,9
17:00:00,0,9
17:10:00,0,9
17:20:00,0,9
17:30:00,0,9
17:40:00,0,10
17:50:00,0,10
18:00:00,0,10
18:10:00,0,10
18:20:00,0,10
18:30:00,0,13
18:40:00,0,13
18:50:00,0,13
19:00:00,0,13
19:10:00,0,13
19:20:00,0,13
19:30:00,0,13
19:40:00,0,13
19:50:00,0,13
20:00:00,0,13
20:10:00,0,13
20:20:00,0,13
20:30:00,0,13
20:40:00,0,13
20:50:00,0,13
21:00:00,0,13
21:10:00,0,13
21:20:00,0,13
21:30:00,0,13
21:40:00,0,13
21:50:00,0,13
22:00:00,0,13
22:10:00,0,16
22:20:00,0,16
22:30:00,0,16
22:40:00,0,16
22:50:00,0,16
23:00:00,0,16
23:10:00,0,16
23:20:00,0,16
23:30:00,0,16
23:40:00,0,17
23:50:00,0,17
