time,floors,total
00:00:00,0,0
00:10:00,0,0
00:20:00,0,0
00:30:00,0,0
00:40:00,0,0
00:50:00,0,0
01:00:00,0,0
01:10:00,0,0
01:20:00,0,0
01:30:00,0,1
01:40:00,0,2
01:50:00,0,2
02:00:00,0,2
02:10:00,0,2
02:20:00,0,2
02:30:00,0,2
02:40:00,0,2
02:50:00,0,2
03:00:00,0,2
03:10:00,0,2
03:20:00,0,2
03:30:00,0,2
03:40:00,0,2
03:50:00,0,4
04:00:00,0,4
04:10:00,0,4
04:20:00,0,4
04:30:00,0,4
04:40:00,0,4
04:50:00,0,4
05:00:00,0,4
05:10:00,0,4
05:20:00,0,4
05:30:00,0,4
05:40:00,0,4
05:50:00,0,4
06:00:00,0,4
06:10:00,0,4
06:20:00,0,4
06:30:00,0,4
06:40:00,0,4
06:50:00,0,4
07:00:00,0,4
07:10:00,0,4
07:20:00,0,4
07:30:00,0,4
07:40:00,0,4
07:50:00,0,4
08:00:00,0,4
08:10:00,0,4
08:20:00,0,4
08:30:00,0,4
08:40:00,0,4
08:50:00,0,4
09:00:00,0,4
09:10:00,0,4
09:20:00,0,4
09:30:00,0,4
09:40:00,0,4
09:50:00,0,4
10:00:00,0,4
10:10:00,0,4
10:20:00,0,4
10:30:00,0,4
10:40:00,0,4
10:50:00,0,4
11:00:00,0,4
11:10:00,0,4
11:20:00,0,4
11:30:00,0,4
11:40:00,0,4
11:50:00,0,4
12:00:00,0,4
12:10:00,0,4
12:20:00,0,4
12:30:00,0,4
12:40:00,0,4
12:50:00,0,4
13:00:00,0,4
13:10:00,0,4
13:20:00,0,4
13:30:00,0,4
13:40:00,0,4
13:50:00,0,4
14:00:00,0,4
14:10:00,0,4
14:20:00,0,4
14:30:00,0,4
14:40:00,0,4
14:50:00,0,6
15:00:00,1,8
15:10:00,0,8
15:20:00,0,8
15:30:00,0,8
15:40:00,0,8
15:50:00,0,12
16:00:00,0,16
16:10:00,0,16
16:20:00,1,18
16:30:00,0,20
16:40:00,0,20
16:50:00,1,21
17:00:00,0,22
17:10:00,0,23
17:20:00,0,23
17:30:00,0,23
17:40:00,0,23
17:50:00,1,24
18:00:00,0,24
18:10:00,0,24
18:20:00,0,24
18:30:00,0,24
18:40:00,0,24
18:50:00,0,24
19:00:00,0,24
19:10:00,0,24
19:20:00,1,25
19:30:00,2,31
19:40:00,0,31
19:50:00,0,31
20:00:00,0,31
20:10:00,0,31
20:20:00,0,31
20:30:00,0,31
20:40:00,0,31
20:50:00,0,31
21:00:00,0,31
21:10:00,0,31
21:20:00,0,31
21:30:00,0,31
21:40:00,0,31
21:50:00,0,31
22:00:00,0,31
22:10:00,0,32
22:20:00,0,33
22:30:00,0,33
22:40:00,0,33
22:50:00,0,33
23:00:00,0,33
23:10:00,0,33
23:20:00,0,33
23:30:00,0,33
23:40:00,0,33
23:50:00,0,33
